{
  "columns": 20,
  "rows": 8,
  "tileSize": 32,
  "visualGrid": {
    "bottom": [
      0, 1, 1, 1, 1, 1, 1, 1, 1, 1, 1, 1, 1, 1, 1, 1, 1, 1, 1, 2,
      23, 24, 24, 24, 24, 24, 24, 24, 24, 24, 24, 24, 24, 24, 24, 24, 24, 24, 24, 25,
      23, 24, 24, 24, 24, 24, 24, 24, 24, 24, 24, 24, 24, 24, 24, 24, 24, 24, 24, 25,
      23, 24, 24, 24, 24, 24, 24, 24, 24, 24, 24, 24, 24, 24, 24, 24, 24, 24, 24, 25,
      23, 24, 24, 24, 24, 24, 24, 24, 24, 24, 24, 24, 24, 24, 24, 24, 24, 24, 24, 25,
      23, 24, 24, 24, 24, 24, 24, 24, 24, 24, 24, 24, 24, 24, 24, 24, 24, 24, 24, 25,
      23, 24, 24, 24, 24, 24, 24, 24, 24, 24, 24, 24, 24, 24, 24, 24, 24, 24, 24, 25,
      46, 47, 47, 47, 47, 47, 47, 47, 47, 47, 47, 47, 47, 47, 47, 47, 47, 47, 47, 48
    ],
    "top": [
      -1, -1, -1, -1, -1, -1, -1, -1, -1, -1, -1, -1, -1, -1, -1, -1, -1, -1, -1, -1,
      -1, -1, -1, -1, -1, -1, -1, -1, -1, -1, -1, -1, -1, -1, -1, -1, -1, -1, -1, -1,
      -1, -1, -1, 115, -1, -1, -1, -1, -1, -1, -1, -1, -1, -1, -1, -1, -1, -1, -1, -1,
      -1, -1, -1, -1, -1, -1, -1, 255, 256, -1, -1, -1, -1, -1, -1, -1, -1, -1, -1, -1,
      -1, -1, -1, -1, -1, -1, -1, 278, 279, -1, -1, -1, -1, -1, -1, -1, -1, -1, -1, -1,
      -1, -1, -1, -1, -1, -1, -1, 253, 254, -1, -1, -1, -1, -1, -1, -1, -1, -1, -1, -1,
      -1, -1, -1, -1, -1, -1, -1, 276, 277, -1, -1, -1, -1, -1, -1, -1, -1, -1, -1, -1,
      -1, -1, -1, -1, -1, -1, -1, -1, -1, -1, -1, -1, -1, -1, -1, -1, -1, -1, -1, -1
    ]
  },
  "logicGrid": [115, 276, 277, 253, 254]
}
